6 8
0 2
EEOOOOOXO
EEOOEOOOO
EEOOOOOOO
EEOOEOEOO
EEOEEEEOO
OOOOOEEOO
EOOOEEEOO
