6 24
0 0
XOEOEOEEOEOEOEOEOEOEOEOEO
OOOOOOOOEOOOEOOOOOOOOOOOE
EEEEEEEEEEEEEEEEEOOOOOOOO
OOOOOOOOOOOOOOOOOOOOOOOOO
OEEEEEEEEEEEEEEEEEEEEEEOO
OOOOOOOOOOOOOOOOOOOOOOOOO
OEEEEEEEEEEOEOEOOOOOOOOOO
