25 73
0 0
XOEOEOEEOEOEOEOEOEOEOEOEOEOEOEOEOEOEOEOEOEOEOEOEOEOEOEOEOEOEOEOEOEOEOEOEOE
OOOOOOOOOOOOOOOOOOOOOOOOOOOOOOOOOOOOOOOOOOOOOOOOOOOOOOOOOOOOOOOOOOOOOOOOEE
OOOOOOOOOOOOOOOOOOOOOOOOOOOEOOOOOOOOOOOOOOOOOOOOOOOOOOOOOOOOOOOOOOOOOOOEOE
OOOOOOOOOOOOOOOOOOOOOOOOOOOOOOOOOOOOOOOOOOOOOOOOOOOOOOOOOOOOOOOOOOOOOOOEOE
OOOOOOOOOOOOOOOOOOOOOOOOOOOEEOOOOOOOOOOOOOOOOOOOOOOOOOOOOOOOOOOOOOOOOOOEEE
OOOEEOOOOOOOOOOOOOOOOOOOOOOEOOOOOOOOOOOOOOOOOOOOOOOOOOOOOOOOOOOOOOOOOOOEEE
OOOOOOOOOOOOOOOOOOOOOOOOOOOEOOOOOOOOOOOOOOOOOOOOOOOOOOOOOOOOOOOOOOOOOOOEOE
OOOOOOOOOOOOOOOOOOOOOOOOOOOEOOOOOOOOOOOOOOOOOOOOOOOOOOOOOOOOOOOOOOOOOOOEOE
EEEEEEEEEEEEEEEEEEEEEEEEEEEEOEOEOEOEOEOEOEOEOEOEOEOEOEOEOEOEOEOEOEOEOEOEOE
OOOOOOOOOEOOOOOOOOOOOOOOOOOOOOOOOOOOOOOOOOOOOOOOOOOOOOOOOOOOOOOOOOOOOOOOEE
OOOOOOOOOOEOOOOOOOOOOOOOOOOOOOOEEEEOOOOOOOOOOOOOOOOOOOOOOOOOOOOOOOOOOOOOEE
OOOOOOOOEOOOEOOEOOOOOOOOEOOOOOEEOOOOEOOOOOOOOOOOOOOOOOOOOOOOOOOOOOOOOOOOEE
EEEEEEEEEEEEEEEEEEEEEEEEEEEEEEEEEEOEEEEEEEEEEEEEEEEEEEEEEEEEEEEEEEEEEEEEEE
OOOOOOEEEEEOOOOOOOOOOOOOOOOOEOOOOOOOOOOOOOOOOOOOOOOOOOOOOOOOOOOOOOOOOOOOEE
EOEOEOOOOEOEOEOEOEOEOEOEOEOEEEOEOEOEOEOEOEOEOEOEOEOEOEOEOEOEOEOEOEOEOEOEOE
EEOOOOOOOOOOOEOEOEOEOOOOOOOEOEOEOEOEOEOEOEOEOEOEOEOEOEOEOEOEOEOEOEOEOEOEOE
EOEOEOOOOOOEOOOOOOOEOEOEOOOEOEOEOEOEOEOEOEOEOEOEOEOEOEOEOEOEOEOEOEOEOEOEOE
EOEOEOEEOEOOOEOEOEOOOEOEOEOEOEOEOEOEOEOEOEOEOEOEOEOEOEOEOEOEOEOEOEOEOEOEOE
EOEOEOEEOEOEOOOEOEOEOOOEOEOEOEOEOEOEOEOEOEOEOEOEOEOEOEOEOEOEOEOEOEOEOEOEOE
EOEOEOEEOEOEOEOEOOOEOEOOOEOEOEOEOEOEOEOEOEOEOEOEOEOEOEOEOEOEOEOEOEOEOEOEOE
EOEOEOEEOEOEOEOEOEOEOEOOOEOEOEOEOEOEOEOEOEOEOEOEOEOEOEOEOEOEOEOEOEOEOEOEOE
EOEOOOEEOEOEOEOEOEOEOEOEOEOEOEOEOEOEOEOEOEOEOEOEOEOEOEOEOEOEOEOEOEOEOEOEOE
EOEOOOEEOEOEOEOEOEOEOEOEOEOEOEOEOEOEOEOEOEOEOEOEOEOEOEOEOEOEOEOEOEOEOEOEOE
EOOOOOOEOEOEOEOEOEOEOEOEOEOEOEOEOEOEOEOEOEOEOEOEOEOEOEOEOEOEOEOEOEOEOEOEOE
OEEEEEEEEEEEEEEEEEEEEEEOEEEOEEOOOOOOOEOEOEOEOEOEOEEEEEEEEEEEEEEEOEEEEEEEEE
OEEEEEEEEEEOEOEOOOOOOOOOOOOOOOOOOOOOOOOOOOOOOOOOOOOOOOOOOOOOOOOOOOOOOOOEEE
