25 73
0 0
XOEOEOEEOEOEOEOEOEOEOEOEOEOEOEOEOEOEOEOEOEOEOEOEOEOEOEOEOEOEOEOEOEOEOEOEOE
OOOOOOOOOOOOOOOOOOOOOOOOOOOOOOOOOOOOOOOOOOOOOOOOOOOOOOOOOOOOOOOOOOOOOOOOEE
OOOOOOOOOOOOOOOOOOOOOOOOOOOEOOOOOOOOOOOOOOOOOOOOOOOOOOOOOOOOOOOOOOOOOOOEOE
OOOOOOOOOOOOOOOOOOOOOOOOOOOOOOOOOOOOOOOOOOOOOOOOOOOOOOOOOOOOOOOOOOOOOOOEOE
OOOOOOOOOOOOOOOOOOOOOOOOOOOEEOOOOOOOOOOOOOOOOOOOOOOOOOOOOOOOOOOOOOOOOOOEEE
OOOEEOOOOOOOOOOOOOOOOOOOOOOEOOOOOOOOOOOOOOOOOOOOOOOOOOOOOOOOOOOOOOOOOOOEEE
OOOOOOOOOOOOOOOOOOOOOOOOOOOEOOOOOOOOOOOOOOOOOOOOOOOOOOOOOOOOOOOOOOOOOOOEOE
OOOOOOOOOOOOOOOOOOOOOOOOOOOEOOOOOOOOOOOOOOOOOOOOOOOOOOOOOOOOOOOOOOOOOOOEOE
OEEEEEEEEEEEEEEEEEEEEEEEEEEEOEOEOEOEOEOEOEOEOEOEOEOEOEOEOEOEOEOEOEOEOEOEOE
OOOOOOOOOEOOOOOOOOOOOOOOOOOOOOOOOOOOOOOOOOOOOOOOOOOOOOOOOOOOOOOOOOOOOOOOEE
OOOOOOOOOOEOOOOOOOOOOOOOOOOOOOOEEEEOOOOOOOOOOOOOOOOOOOOOOOOOOOOOOOOOOOOOEE
OOOOOOOOEOOOEOOEOOOOOOOOEOOOOOEEOOOOEOOOOOOOOOOOOOOOOOOOOOOOOOOOOOOOOOOOEE
OEEEEEEEEEEEEEEEEEEEEEEEEEEEEEEEEEOEEEEEEEEEEEEEEEEEEEEEEEEEEEEEEEEEEEEEEE
OOOOOOEEEEEOOOOOOOOOOOOOOOOOEOOOOOOOOOOOOOOOOOOOOOOOOOOOOOOOOOOOOOOOOOOOEE
OOEOEOOOOEOEOEOEOEOEOEOEOEOEEEOEOEOEOEOEOEOEOEOEOEOEOEOEOEOEOEOEOEOEOEOEOE
OEOOOOOOOOOOOEOEOEOEOOOOOOOEOEOEOEOEOEOEOEOEOEOEOEOEOEOEOEOEOEOEOEOEOEOEOE
OOEOEOOOOOOEOOOOOOOEOEOEOOOEOEOEOEOEOEOEOEOEOEOEOEOEOEOEOEOEOEOEOEOEOEOEOE
OOEOEOEEOEOOOEOEOEOOOEOEOEOEOEOEOEOEOEOEOEOEOEOEOEOEOEOEOEOEOEOEOEOEOEOEOE
OOEOEOEEOEOEOOOEOEOEOOOEOEOEOEOEOEOEOEOEOEOEOEOEOEOEOEOEOEOEOEOEOEOEOEOEOE
OOEOEOEEOEOEOEOEOOOEOEOOOEOEOEOEOEOEOEOEOEOEOEOEOEOEOEOEOEOEOEOEOEOEOEOEOE
OOEOEOEEOEOEOEOEOEOEOEOOOEOEOEOEOEOEOEOEOEOEOEOEOEOEOEOEOEOEOEOEOEOEOEOEOE
OOEOOOEEOEOEOEOEOEOEOEOEOEOEOEOEOEOEOEOEOEOEOEOEOEOEOEOEOEOEOEOEOEOEOEOEOE
OOEOOOEEOEOEOEOEOEOEOEOEOEOEOEOEOEOEOEOEOEOEOEOEOEOEOEOEOEOEOEOEOEOEOEOEOE
OOOOOOOEOEOEOEOEOEOEOEOEOEOEOEOEOEOEOEOEOEOEOEOEOEOEOEOEOEOEOEOEOEOEOEOEOE
OEEEEEEEEEEEEEEEEEEEEEEOEEEOEEOOOOOOOEOEOEOEOEOEOEEEEEEEEEEEEEEEOEEEEEEEEE
OEEEEEEEEEEOEOEOOOOOOOOOOOOOOOOOOOOOOOOOOOOOOOOOOOOOOOOOOOOOOOOOOOOOOOOEEE
