6 8
2 2
EEOOOOOXO
EEOOEOOOO
EEOOOOOOO
EEOOEOEOO
EEOEEEEOO
OOOOOEEOO
EOOOEEEOO
